theme 1
#########################################
#    #                                ###
#    #                     ###          #
#    #                     ###          #
#    #                     ###          #
#    #                                  #
#    ################                   #
#                                      ##
#    ################                   #
#    #                                  #
#    #                                  #
#    ####################################
#    #                                  #
#    #                                  #
#    #################                  #
#                    #                  #
#                    #                  #
#                    #                  #
#                    #                  #
#                    #                  #
#         ############          # #     #
#         #                             #
#         #                             #
#                                       #
#         #                             #
#         #                             #
#         #                             #
#         #                             #
#         #                             #
#########################################